+-----+-------+-------+----------+----------+-------------+
| rid | level | bet   | revision | validate | version_min |
+-----+-------+-------+----------+----------+-------------+
|   1 |     1 |   100 |      309 |        1 |           1 |
|   2 |     1 |   200 |      309 |        1 |           1 |
|   3 |     2 |   400 |      309 |        1 |           1 |
|   4 |     3 |   600 |      309 |        1 |           1 |
|   5 |     4 |  1000 |      309 |        1 |           1 |
|   6 |     6 |  1600 |      309 |        1 |           1 |
|   7 |     8 |  2000 |      309 |        1 |           1 |
|   8 |    11 |  2400 |      309 |        1 |           1 |
|   9 |    14 |  3000 |      309 |        1 |           1 |
|  10 |    17 |  3600 |      309 |        1 |           1 |
|  11 |    20 |  4000 |      309 |        1 |           1 |
|  12 |    23 |  4400 |      309 |        1 |           1 |
|  13 |    26 |  5000 |      309 |        1 |           1 |
|  14 |    32 |  5600 |      309 |        1 |           1 |
|  15 |    38 |  6000 |      309 |        1 |           1 |
|  16 |    44 |  7000 |      309 |        1 |           1 |
|  17 |    44 |  8000 |      309 |        1 |           1 |
|  18 |    50 |  9000 |      309 |        1 |           1 |
|  19 |    56 | 10000 |      309 |        1 |           1 |
|  20 |    62 | 11000 |      309 |        1 |           1 |
|  21 |    68 | 12000 |      309 |        1 |           1 |
|  22 |    74 | 13000 |      309 |        1 |           1 |
|  23 |    80 | 16000 |      309 |        1 |           1 |
|  24 |    90 | 18000 |      309 |        1 |           1 |
|  25 |   100 | 20000 |      309 |        1 |           1 |
|  26 |   110 | 25000 |      309 |        1 |           1 |
|  27 |   120 | 30000 |      309 |        1 |           1 |
|  28 |   130 | 35000 |      309 |        1 |           1 |
|  29 |   140 | 40000 |      309 |        1 |           1 |
|  30 |   150 | 45000 |      309 |        1 |           1 |
|  31 |   160 | 50000 |      309 |        1 |           1 |
|  32 |   170 | 55000 |      309 |        1 |           1 |
|  33 |   180 | 60000 |      309 |        1 |           1 |
|  34 |   190 | 65000 |      309 |        1 |           1 |





'1', '1', '10', '1', '1', '1'
'2', '1', '25', '1', '1', '1'
'3', '1', '50', '1', '1', '1'
'4', '1', '100', '1', '1', '1'
'5', '1', '200', '1', '1', '1'
'6', '2', '500', '1', '1', '1'
'7', '3', '1000', '1', '1', '1'
'8', '4', '1500', '1', '1', '1'
'9', '5', '2000', '1', '1', '1'
'10', '7', '2500', '1', '1', '1'
'11', '9', '5000', '1', '1', '1'
'12', '15', '10000', '1', '1', '1'
'13', '20', '15000', '1', '1', '1'
'14', '25', '20000', '1', '1', '1'
'15', '30', '25000', '1', '1', '1'
'16', '35', '30000', '1', '1', '1'
'17', '40', '50000', '1', '1', '1'
'18', '50', '100000', '1', '1', '1'
'19', '100', '200000', '1', '1', '1'
'20', '200', '250000', '1', '1', '1'
'21', '300', '300000', '1', '1', '1'
'22', '500', '500000', '1', '1', '1'
'24', '800', '1000000', '1', '1', '1'
'25', '1000', '1500000', '1', '1', '1'
'26', '1100', '2000000', '1', '1', '1'
'27', '1200', '2500000', '1', '1', '1'
'28', '1800', '3000000', '1', '1', '1'
'29', '2000', '3500000', '1', '1', '1'
'30', '2200', '4000000', '1', '1', '1'
'31', '2400', '4500000', '1', '1', '1'
'32', '9000', '5000000', '1', '1', '1'
'33', '9100', '5500000', '1', '1', '1'